11111111111111
100011000000E1
1P0000P0000001
11111111111111