1111111111
1E0CCCCC01
1111111101
1CCCC00001
1111111101
1P00000001
1111111111