1111111111
1P00000001
1111111001
1000000001
1111111001
1000CC00E1
1111111111