111111111111111
1P10000CCCCCCE1
111000000000CC1
100000000000001
100000000000001
100000000000001
111111111111111