111111111111111
1P00000000001E1
111111000000101
1CCCCC000000101
111111000000101
1CCCCC000000001
111111111111111