11111111111111
1000000000000111111
100000000000E111111
1PCCCCC1111111
11111111111111