11111111111111111111111
1P001CCCCCC000000000001
11111111111000000000001
10000000000000011111101
1CCCCCCC0000000000001C1
1CCCCCCC0000000000001E1
11111111111111111111111