111111111111
1000000000E1
100000000111
1P00010CCCC1
100001000001
100001000001
111111111111